38
45
00 00 00 00 00 00 00 00 00 00 00 00 00 00 00 00 00 00 00 00 00 00 00 00 00 00 00 00 00 00 00 00 00 00 00 00 00 00 00 00 00 00 00 00 00
00 00 00 00 00 00 -1 -1 00 00 00 00 00 00 00 00 00 00 00 00 00 00 00 00 00 00 00 00 00 00 00 00 00 00 -1 -1 00 00 00 00 00 00 00 00 00
00 -1 -1 -1 -1 00 -1 -1 00 -1 -1 -1 -1 -1 -1 -1 00 -1 00 00 00 00 00 -1 00 00 00 00 00 00 00 00 00 00 -1 -1 00 00 00 00 00 00 00 00 00
-1 -1 00 -1 -1 00 00 00 00 -1 -1 -1 -1 -1 -1 -1 00 -1 -1 00 00 00 00 -1 00 00 00 00 00 -1 -1 -1 00 00 00 00 00 00 -1 00 00 00 00 -1 -1 
-1 -1 00 00 -1 00 -1 -1 00 00 00 00 -1 -1 00 00 00 -1 -1 00 00 00 00 -1 00 00 00 -1 -1 -1 -1 -1 00 00 -1 -1 00 00 -1 -1 -1 00 -1 -1 -1 
-1 -1 00 00 00 00 -1 -1 00 00 00 00 -1 -1 00 00 00 -1 -1 -1 00 -1 -1 -1 00 00 00 -1 00 00 00 -1 00 00 -1 -1 00 00 -1 -1 -1 -1 -1 -1 -1 
-1 -1 00 00 00 00 -1 -1 00 00 00 00 -1 -1 00 00 00 00 -1 -1 -1 -1 -1 00 00 00 00 -1 00 00 00 00 00 00 -1 -1 00 00 -1 -1 00 -1 00 -1 -1 
-1 -1 00 00 00 00 -1 -1 00 00 00 00 -1 -1 00 00 00 00 00 00 -1 00 00 00 00 00 00 -1 00 00 00 00 00 00 -1 -1 00 00 -1 -1 00 00 00 -1 -1 
-1 -1 00 00 00 00 -1 -1 00 00 00 00 -1 -1 00 00 00 00 00 00 -1 00 00 00 00 00 00 00 -1 -1 -1 00 00 00 -1 -1 00 00 -1 -1 00 00 00 -1 -1 
-1 -1 00 00 00 00 -1 -1 00 00 00 00 -1 -1 00 00 00 00 00 -1 -1 00 00 00 00 00 00 00 00 00 -1 -1 00 00 -1 -1 00 00 -1 -1 00 00 00 -1 -1 
-1 -1 00 00 00 00 -1 -1 00 00 00 00 -1 -1 00 00 00 00 00 -1 -1 00 00 00 00 00 00 00 00 00 -1 -1 00 00 -1 -1 00 00 -1 -1 00 00 00 -1 -1 
-1 -1 00 00 -1 00 -1 -1 00 00 00 00 -1 -1 00 00 00 00 -1 -1 00 00 00 00 00 00 00 00 00 00 -1 -1 00 00 -1 -1 00 00 -1 -1 00 00 00 -1 -1 
-1 -1 00 -1 -1 00 -1 -1 00 00 00 00 -1 -1 00 00 00 00 -1 -1 00 00 00 00 00 00 00 00 00 00 -1 -1 00 00 -1 -1 00 00 -1 -1 00 00 00 -1 -1 
00 -1 -1 -1 00 00 -1 -1 00 00 00 00 -1 -1 00 00 00 00 -1 -1 00 00 00 00 00 00 00 00 -1 -1 -1 00 00 00 -1 -1 -1 00 -1 -1 00 00 00 -1 -1
00 00 00 00 00 00 00 00 00 00 00 00 00 00 00 00 00 00 00 00 00 00 00 00 00 00 00 00 00 00 00 00 00 00 00 00 00 00 00 00 00 00 00 00 00
00 00 00 00 00 00 00 00 00 00 00 00 00 00 00 00 00 00 00 00 00 00 00 00 00 00 00 00 00 00 00 00 00 00 00 00 00 00 00 00 00 00 00 00 00
00 00 01 00 00 01 02 00 00 02 03 00 00 03 04 00 00 04 05 00 00 05 06 00 00 06 07 00 00 07 08 00 00 08 09 00 00 09 10 00 00 10 00 00 00
00 00 01 01 01 01 02 02 02 02 03 03 03 03 04 04 04 04 05 05 05 05 06 06 06 06 07 07 07 07 08 08 08 08 09 09 09 09 10 10 10 10 00 00 00
00 00 01 01 01 01 02 02 02 02 03 03 03 03 04 04 04 04 05 05 05 05 06 06 06 06 07 07 07 07 08 08 08 08 09 09 09 09 10 00 10 10 00 00 00
00 00 01 01 01 01 02 02 02 02 03 03 03 03 04 04 04 04 05 05 05 05 06 06 06 06 07 07 07 07 08 08 08 08 09 09 09 09 10 10 10 10 00 00 00
00 00 11 11 11 11 12 12 12 12 13 13 13 13 14 14 14 14 15 15 15 15 16 16 16 16 17 17 17 17 18 18 18 18 19 19 19 19 10 10 10 10 00 00 00
00 00 11 11 11 11 12 12 12 12 13 13 13 13 14 14 14 14 15 15 15 15 16 16 16 16 17 17 17 17 18 18 18 18 19 19 19 19 10 00 10 10 00 00 00
00 00 11 11 11 11 12 12 12 12 13 13 13 13 14 14 14 14 15 15 15 15 16 16 16 16 17 17 17 17 18 18 18 18 19 19 19 19 10 10 10 10 00 00 00
00 00 11 00 00 11 12 00 00 12 13 00 00 13 14 00 00 14 15 00 00 15 16 00 00 16 17 00 00 17 18 00 00 18 19 00 00 19 20 00 00 20 00 00 00
00 00 00 00 00 00 00 00 00 00 00 00 00 00 00 00 00 00 00 00 00 00 00 00 00 00 00 00 00 00 00 00 00 00 00 00 00 00 00 00 00 00 00 00 00
00 00 00 00 00 00 00 00 00 00 00 00 00 00 00 00 00 00 00 00 00 00 00 00 00 00 00 00 00 00 00 00 00 00 00 00 00 00 00 00 00 00 00 00 00
00 00 31 00 00 31 32 00 00 32 33 00 00 33 34 00 00 34 35 00 00 35 36 00 00 36 37 00 00 37 38 00 00 38 39 00 00 39 40 00 00 40 00 00 00
00 00 31 31 31 31 32 32 32 32 33 33 33 33 34 34 34 34 35 35 35 35 36 36 36 36 37 37 37 37 38 38 38 38 39 39 39 39 40 40 40 40 00 00 00
00 00 31 31 31 31 32 32 32 32 33 33 33 33 34 34 34 34 35 35 35 35 36 36 36 36 37 37 37 37 38 38 38 38 39 39 39 39 40 40 40 40 00 00 00
00 00 31 31 31 31 32 32 32 32 33 33 33 33 34 34 34 34 35 35 35 35 36 36 36 36 37 37 37 37 38 38 38 38 39 39 39 39 40 40 40 40 00 00 00
00 00 41 41 41 41 42 42 42 42 43 43 43 43 44 44 44 44 45 45 45 45 46 46 46 46 47 47 47 47 48 48 48 48 49 49 49 49 50 50 50 50 00 00 00
00 00 41 41 41 41 42 42 42 42 43 43 43 43 44 44 44 44 45 45 45 45 46 46 46 46 47 47 47 47 48 48 48 48 49 49 49 49 50 50 50 50 00 00 00
00 00 41 41 41 41 42 42 42 42 43 43 43 43 44 44 44 44 45 45 45 45 46 46 46 46 47 47 47 47 48 48 48 48 49 49 49 49 50 50 50 50 00 00 00
00 00 41 00 00 41 42 00 00 42 43 00 00 43 44 00 00 44 45 00 00 45 46 00 00 16 47 00 00 47 48 00 00 48 49 00 00 49 50 00 00 50 00 00 00
00 00 00 00 00 00 00 00 00 00 00 00 00 00 00 00 00 00 00 00 00 00 00 00 00 00 00 00 00 00 00 00 00 00 00 00 00 00 00 00 00 00 00 00 00
00 00 00 00 00 00 00 00 00 00 00 00 00 00 00 00 00 00 00 00 00 00 00 00 00 00 00 00 00 00 00 00 00 00 00 00 00 00 00 00 00 00 00 00 00
00 00 00 00 00 00 00 00 00 00 00 00 00 00 00 00 00 00 00 00 00 00 00 00 00 00 00 00 00 00 00 00 00 00 00 00 00 00 00 00 00 00 00 00 00
00 00 00 00 00 00 00 00 00 00 00 00 00 00 00 00 00 00 00 00 00 00 00 00 00 00 00 00 00 00 00 00 00 00 00 00 00 00 00 00 00 00 00 00 00