49
50
01 01 01 -1 -1 -2 -2 -2 -2 -2 00 -2 -2 -2 -2 99 99 99 99 99 99 99 99 99 99 99 99 99 99 99 99 99 99 99 99 00 00 00 00 00 00 00 00 00 00 10 10 10 10 10 
01 01 01 -1 -1 00 00 00 00 00 00 00 00 00 00 99 99 99 99 99 99 99 99 99 99 99 99 99 99 99 99 99 99 99 99 00 00 00 00 00 00 00 00 00 00 10 10 10 10 10 
01 01 01 00 00 00 00 00 00 00 00 00 00 00 00 99 99 99 99 99 99 99 99 99 99 99 99 99 99 99 99 99 99 99 99 00 00 00 00 00 00 00 00 00 00 00 00 10 10 10 
01 01 01 -1 -1 00 00 00 00 00 00 00 00 00 00 99 99 99 99 99 99 99 99 99 99 99 99 99 99 99 99 99 99 99 99 00 00 00 00 00 00 00 00 00 00 10 10 10 10 10 
01 01 01 -1 -1 00 00 00 00 00 00 00 00 00 00 99 99 99 99 99 99 99 99 99 99 99 99 99 99 99 99 99 99 99 99 00 00 00 00 00 00 00 00 00 00 10 10 10 10 10 
02 02 02 -1 -1 00 00 00 00 00 00 00 00 00 00 99 99 99 99 99 99 99 99 99 99 99 99 99 99 99 99 99 99 99 99 00 00 00 00 00 00 00 00 00 00 11 11 11 11 11 
02 02 02 -1 -1 00 00 00 00 00 00 00 00 00 00 99 99 99 99 99 99 99 99 99 99 99 99 99 99 99 99 99 99 99 99 00 00 00 00 00 00 00 00 00 00 11 11 11 11 11 
02 02 02 00 00 00 00 00 00 00 00 00 00 00 00 99 99 99 99 99 99 99 99 99 99 99 99 99 99 99 99 99 99 99 99 00 00 00 00 00 00 00 00 00 00 00 00 11 11 11 
02 02 02 -1 -1 00 00 00 00 00 00 00 00 00 00 99 99 99 99 99 99 99 99 99 99 99 99 99 99 99 99 99 99 99 99 00 00 00 00 00 00 00 00 00 00 11 11 11 11 11 
02 02 02 -1 -1 00 00 00 00 00 00 00 00 00 00 99 99 99 99 99 99 99 99 99 99 99 99 99 99 99 99 99 99 99 99 00 00 00 00 00 00 00 00 00 00 11 11 11 11 11 
03 03 03 -1 -1 00 00 00 00 00 00 00 00 00 00 00 00 00 00 00 00 00 00 00 00 00 00 00 00 00 00 00 00 00 00 00 00 00 00 00 00 00 00 00 00 12 12 12 12 12 
03 03 03 -1 -1 00 00 00 00 00 00 00 00 00 00 00 00 00 00 00 00 00 00 00 00 00 00 00 00 00 00 00 00 00 00 00 00 00 00 00 00 00 00 00 00 12 12 12 12 12 
03 03 03 00 00 00 00 00 00 00 00 00 00 00 00 00 00 00 00 00 00 00 00 00 00 00 00 00 00 00 00 00 00 00 00 00 00 00 00 00 00 00 00 00 00 00 00 12 12 12 
03 03 03 03 03 00 00 00 00 00 00 00 00 00 00 00 00 00 00 00 00 00 00 00 00 00 00 00 00 00 00 00 00 00 00 00 00 00 00 00 00 00 00 00 00 12 12 12 12 12 
03 03 03 03 03 00 00 00 00 00 00 00 -1 -1 19 19 19 24 24 24 -1 -1 00 00 00 00 00 00 29 29 29 29 34 34 34 34 34 00 00 00 00 00 00 00 00 12 12 12 12 12 
04 04 04 04 04 00 00 00 00 00 00 00 00 -1 19 19 19 24 24 24 -1 00 00 00 00 00 00 00 29 29 29 29 34 34 34 34 34 00 00 00 00 00 00 00 00 13 13 13 13 13 
04 04 04 04 04 00 00 00 00 00 00 00 00 00 19 19 19 24 24 24 00 00 00 00 00 00 00 00 00 00 29 29 34 34 34 00 00 00 00 00 00 00 00 00 00 13 13 13 13 13 
04 04 04 00 00 00 00 00 00 00 00 00 00 -1 19 19 19 24 24 24 -1 00 00 00 00 00 00 00 29 29 29 29 34 34 34 34 34 00 00 00 00 00 00 00 00 00 00 13 13 13 
04 04 04 04 04 00 00 00 00 00 00 00 -1 -1 19 19 19 24 24 24 -1 -1 00 00 00 00 00 00 29 29 29 29 34 34 34 34 34 00 00 00 00 00 00 00 00 13 13 13 13 13 
04 04 04 04 04 00 00 00 00 00 00 00 -1 -1 20 20 20 25 25 25 -1 -1 00 00 00 00 00 00 30 30 30 30 35 35 35 35 35 00 00 00 00 00 00 00 00 13 13 13 13 13 
05 05 05 05 05 00 00 00 00 00 00 00 -1 -1 20 20 20 25 25 25 -1 00 00 00 00 00 00 00 30 30 30 30 35 35 35 35 35 00 00 00 00 00 00 00 00 14 14 14 14 14 
05 05 05 05 05 00 00 00 00 00 00 00 00 00 20 20 20 25 25 25 00 00 00 00 00 00 00 00 00 00 30 30 35 35 35 00 00 00 00 00 00 00 00 00 00 14 14 14 14 14 
05 05 05 00 00 00 00 00 00 00 00 00 -1 -1 20 20 20 25 25 25 -1 00 00 00 00 00 00 00 30 30 30 30 35 35 35 35 35 00 00 00 00 00 00 00 00 00 00 14 14 14 
05 05 05 05 05 00 00 00 00 00 00 00 -1 -1 20 20 20 25 25 25 -1 -1 00 00 00 00 00 00 30 30 30 30 35 35 35 35 35 00 00 00 00 00 00 00 00 14 14 14 14 14 
05 05 05 05 05 00 00 00 00 00 00 00 -1 -1 21 21 21 26 26 26 -1 -1 00 00 00 00 00 00 31 31 31 31 36 36 36 36 36 00 00 00 00 00 00 00 00 14 14 14 14 14 
06 06 06 06 06 00 00 00 00 00 00 00 00 -1 21 21 21 26 26 26 -1 00 00 00 00 00 00 00 31 31 31 31 36 36 36 36 36 00 00 00 00 00 00 00 00 15 15 15 15 15 
06 06 06 06 06 00 00 00 00 00 00 00 00 00 21 21 21 26 26 26 00 00 00 00 00 00 00 00 00 00 31 31 36 36 36 00 00 00 00 00 00 00 00 00 00 15 15 15 15 15 
06 06 06 00 00 00 00 00 00 00 00 00 00 -1 21 21 21 26 26 26 -1 00 00 00 00 00 00 00 31 31 31 31 36 36 36 36 36 00 00 00 00 00 00 00 00 00 00 15 15 15 
06 06 06 06 06 00 00 00 00 00 00 00 -1 -1 21 21 21 26 26 26 -1 -1 00 00 00 00 00 00 31 31 31 31 36 36 36 36 36 00 00 00 00 00 00 00 00 15 15 15 15 15 
06 06 06 06 06 00 00 00 00 00 00 00 -1 -1 22 22 22 27 27 27 -1 -1 00 00 00 00 00 00 32 32 32 32 37 37 37 37 37 00 00 00 00 00 00 00 00 15 15 15 15 15 
07 07 07 07 07 00 00 00 00 00 00 00 00 -1 22 22 22 27 27 27 -1 00 00 00 00 00 00 00 32 32 32 32 37 37 37 37 37 00 00 00 00 00 00 00 00 16 16 16 16 16 
07 07 07 07 07 00 00 00 00 00 00 00 00 00 22 22 22 27 27 27 00 00 00 00 00 00 00 00 00 00 32 32 37 37 37 00 00 00 00 00 00 00 00 00 00 16 16 16 16 16 
07 07 07 00 00 00 00 00 00 00 00 00 00 -1 22 22 22 27 27 27 -1 00 00 00 00 00 00 00 32 32 32 32 37 37 37 37 37 00 00 00 00 00 00 00 00 00 00 16 16 16 
07 07 07 07 07 00 00 00 00 00 00 00 -1 -1 22 22 22 27 27 27 -1 -1 00 00 00 00 00 00 32 32 32 32 37 37 37 37 37 00 00 00 00 00 00 00 00 16 16 16 16 16 
07 07 07 07 07 00 00 00 00 00 00 00 -1 -1 23 23 23 28 28 28 -1 -1 00 00 00 00 00 00 33 33 33 33 38 38 38 38 38 00 00 00 00 00 00 00 00 16 16 16 16 16 
08 08 08 08 08 00 00 00 00 00 00 00 00 -1 23 23 23 28 28 28 -1 00 00 00 00 00 00 00 33 33 33 33 38 38 38 38 38 00 00 00 00 00 00 00 00 17 17 17 17 17 
08 08 08 08 08 00 00 00 00 00 00 00 00 00 23 23 23 28 28 28 00 00 00 00 00 00 00 00 00 00 33 33 38 38 38 00 00 00 00 00 00 00 00 00 00 17 17 17 17 17 
08 08 08 00 00 00 00 00 00 00 00 00 00 -1 23 23 23 28 28 28 -1 00 00 00 00 00 00 00 33 33 33 33 38 38 38 38 38 00 00 00 00 00 00 00 00 00 00 17 17 17 
08 08 08 -1 -1 00 00 00 00 00 00 00 -1 -1 23 23 23 28 28 28 -1 -1 00 00 00 00 00 00 33 33 33 33 38 38 38 38 38 00 00 00 00 00 00 00 00 17 17 17 17 17 
08 08 08 -1 -1 00 00 00 00 00 00 00 00 00 00 00 00 00 00 00 00 00 00 00 00 00 00 00 00 00 00 00 00 00 00 00 00 00 00 00 00 00 00 00 00 17 17 17 17 17 
09 09 09 -1 -1 00 00 00 00 00 00 00 00 00 00 00 00 00 00 00 00 00 00 00 00 00 00 00 00 00 00 00 00 00 00 00 00 00 00 00 00 00 00 00 00 18 18 18 18 18 
09 09 09 -1 -1 00 00 00 00 00 00 00 00 00 00 00 00 00 00 00 00 00 00 00 00 00 00 00 00 00 00 00 00 00 00 00 00 00 00 00 00 00 00 00 00 18 18 18 18 18 
09 09 09 00 00 00 00 00 00 00 00 00 00 00 00 00 00 00 00 00 00 00 00 00 00 00 00 00 00 00 00 00 00 00 00 00 00 00 00 00 00 00 00 00 00 00 00 18 18 18 
09 09 09 -1 -1 00 00 00 00 00 00 00 00 00 00 00 00 00 00 00 00 00 00 00 00 00 00 00 00 00 00 00 00 00 00 00 00 00 00 00 00 00 00 00 00 18 18 18 18 18 
09 09 09 -1 -1 00 00 00 00 00 00 00 00 00 00 00 00 00 00 00 00 00 00 00 00 00 00 00 00 00 00 00 00 00 00 00 00 00 00 00 00 00 00 00 00 18 18 18 18 18 
-2 00 00 00 00 00 00 00 00 00 00 00 00 00 00 00 00 00 00 00 00 00 00 00 00 00 00 00 00 00 00 00 00 00 00 00 00 00 00 00 00 00 00 00 00 00 00 00 00 00 
-2 00 00 00 00 00 00 00 00 00 00 00 00 00 00 00 00 00 00 00 00 00 00 00 00 00 00 00 00 00 00 00 00 00 00 00 00 00 00 00 00 00 00 00 00 00 00 00 00 00 
-2 00 00 00 00 00 00 00 00 00 00 00 00 00 00 00 00 00 00 00 00 00 00 00 00 00 00 00 00 00 00 00 00 00 00 00 00 00 00 00 00 00 00 00 00 00 00 00 00 00 
-2 00 00 00 -2 -2 -2 -2 00 00 00 00 00 00 00 00 00 00 00 00 00 00 00 00 00 00 00 00 00 00 00 00 00 00 00 00 00 00 00 00 00 00 00 00 00 00 00 00 00 00 
